#########
#.......#
#.##.FF.#
#.##....#
#....G..#
#.......#
#.@.##..#
#########