#########
#       #
#   @   #
#   G   #
#       #
#       #
#       #
#       #
#########