#########
#.......#
#...@...#
#.......#
#.......#
#..GGG..#
#.......#
#########