#########
# F     #
#       #
#       #
#    G  #
#       #
#       #
#   @   #
#########