#########
#       #
#   @   #
#       #
#       #
#    #  #
#  #    #
#  F  S #
#########