#########
#       #
#   @   #
#       #
#       #
#  GGG  #
#       #
#       #
#########