########
#.S....#
#..@...#
#......#
#......#
#.S..S.#
#......#
########