########
#......#
#..@...#
#......#
#......#
#.S..S.#
#......#
########