#########
#       #
# ## FF #
# ##    #
#    G  #
#       #
# @ ##  #
#########