#########
#       #
#   @   #
#       #
#       #
#       #
#       #
#  S    #
#########