#########
#      @#
#G     ##
#       #
#       #
#   F   #
#       #
#S      #
#########