#########
#       #
#   @   #
#       #
#       #
#   F   #
#       #
#       #
#########